  #                 #
 # #               # # 
#   ###############   #
# $                 $ #
#  $##$         $##$  #
#   ##     @     ##   #
#          #          #
#     # . . . . #     #
#     .#########.     #
#                     #
#                     #
#######################
