##############################
#       #             # .    #
#   $   #             #      #
#   $   #$            #      #
#       #             #      #
#       #             #      #
#       #     #       #     .#
#             #              #
#             #              #
#             #              #
#      #################     #
#            $               #
#                            #
#       #        #  #####    #
#       #        #  #.       #
#       #        #  #        #
#      $#        # .#        #
#       #        #  #        #
#@      #        #  #.       #
##############################