                              
                              
                              
       ####                   
       #  #                   
       #  #                   
     ###  #    #########      
    ##    ###### $    .#      
    # @          #$# # #      
    #   ###      $     #      
    # # ...  $###### #.#      
    #   ###   #    #   #      
    #    #  #$#    # # #      
    # $       ###  #  .#      
    ###  $      #  #####      
      ######    #             
           #   .#             
           ######             
                              
                              
                              