############
#....  #   #
#.#.   # $ #
#...  $  $ #
# ##$  $  ##
# #   # # ##
# #@ ####  #
#  $  # ## #
###  $     #
## $#  ##$ #
##    ##   #
############
