-	-	-	-	-	-	-	-	-	-	-	-	-	-	-	-	-	-	-	-	-	-	-	-	-	-	-	-	-	-
-	-	-	-	-	-	-	-	-	-	-	-	-	-	-	-	-	-	-	-	-	-	-	-	-	-	-	-	-	-
-	-	-	-	#	#	#	#	-	-	-	-	-	-	-	-	-	-	-	-	-	-	-	-	-	-	-	-	-	-
-	-	-	-	#	-	-	#	-	-	-	-	-	-	-	-	-	-	-	-	-	-	-	-	-	-	-	-	-	-
-	-	#	#	#	$	-	#	#	-	-	-	-	-	-	-	-	-	-	-	-	-	-	-	-	-	-	-	-	-
-	-	#	-	-	-	-	-	#	#	#	-	-	-	-	-	-	-	-	-	-	-	-	-	-	-	-	-	-	-
-	-	#	-	-	-	-	-	$	-	#	-	-	-	-	-	-	-	-	-	-	-	-	-	-	-	-	-	-	-
-	-	#	-	-	.	-	-	-	-	#	-	-	-	-	-	-	-	-	-	-	-	-	-	-	-	-	-	-	-
-	-	#	-	-	#	-	-	-	-	#	#	-	-	-	-	-	-	-	-	-	-	-	-	-	-	-	-	-	-
-	-	#	-	.	#	-	$	-	-	+	#	#	#	#	#	#	#	#	-	-	-	-	-	-	-	-	-	-	-
-	-	#	-	.	-	-	-	-	-	$	-	-	-	-	-	-	-	#	-	-	-	-	-	-	-	-	-	-	-
-	-	#	#	#	#	#	#	#	#	#	-	-	-	-	-	$	-	#	-	-	-	-	-	-	-	-	-	-	-
-	-	-	-	-	-	-	-	-	-	#	#	#	#	#	#	-	.	#	-	-	-	-	-	-	-	-	-	-	-
-	-	-	-	-	-	-	-	-	-	-	-	-	-	-	#	#	#	#	-	-	-	-	-	-	-	-	-	-	-
-	-	-	-	-	-	-	-	-	-	-	-	-	-	-	-	-	-	-	-	-	-	-	-	-	-	-	-	-	-
-	-	-	-	-	-	-	-	-	-	-	-	-	-	-	-	-	-	-	-	-	-	-	-	-	-	-	-	-	-
-	-	-	-	-	-	-	-	-	-	-	-	-	-	-	-	-	-	-	-	-	-	-	-	-	-	-	-	-	-
-	-	-	-	-	-	-	-	-	-	-	-	-	-	-	-	-	-	-	-	-	-	-	-	-	-	-	-	-	-
-	-	-	-	-	-	-	-	-	-	-	-	-	-	-	-	-	-	-	-	-	-	-	-	-	-	-	-	-	-
-	-	-	-	-	-	-	-	-	-	-	-	-	-	-	-	-	-	-	-	-	-	-	-	-	-	-	-	-	-
-	-	-	-	-	-	-	-	-	-	-	-	-	-	-	-	-	-	-	-	-	-	-	-	-	-	-	-	-	-