------------------------------
------------------------------
------------------------------
-------####-------------------
-------#--#-------------------
-------#--#-------------------
-----###--#----#########------
----##----######-$----.#------
----#-@----------#$#-#-#------
----#---###------$-----#------
----#-#-...--$######-#.#------
----#---###---#----#---#------
----#----#--#$#----#-#-#------
----#-$-------###--#--.#------
----###--$------#--#####------
------######----#-------------
-----------#---.#-------------
-----------######-------------
------------------------------
------------------------------
------------------------------