##################
#@##         ###.#####
# $   ### #$ #  $   .#
# $   #   #  # $  .# ##
##### #$###$ # #$  #$ #
    #...$      #.  #  #
    #...############  #
    #####             #
        # #############
        # $          .#
        ###############
