  ####   ####
 #    # #    #
#      #      #
#     * $     #
#    .     $$ #
 #    .   $  #
  # $  +    #
   #    .$ #
    #  .  #
     # . #
      # #
       #
