#######
###@# #
###$. #
# $   #
# . $.#
#     #
#######
