##############
#...#   #    #
#...# #$###$ #
#. @    #    #
#$# #$       #
#   #        #
#######   ######
#     #   #    #
# $   #     $  #
#         #    #
#      $  ######
##### # ###
    #   #
    #####
